border_size=1
usage=map

Mm^Xm       , Mm^Xm       , Mm^Xm       , Mm^Xm       , Mm^Xm       , Mm^Xm       , Mm^Xm       , Mm^Xm       , Mm^Xm       , Mm^Xm       , Mm^Xm       , Mm^Xm       , Mm^Xm       , Mm^Xm       , Mm^Xm       , Mm^Xm       , Mm^Xm       , Mm^Xm       , Mm^Xm       , Mm^Xm       , Mm^Xm       , Gg          
Mm^Xm       , 4 Mm^Xm     , Mm^Xm       , Mm^Xm       , Mm^Xm       , Mm^Xm       , Mm^Xm       , Mm^Xm       , Mm^Xm       , Mm^Xm       , Mm^Xm       , Mm^Xm       , Mm^Xm       , Mm^Xm       , Mm^Xm       , Mm^Xm       , Mm^Xm       , Mm^Xm       , Mm^Xm       , Mm^Xm       , Mm^Xm       , Mm^Xm       
Mm^Xm       , Mm^Xm       , Mm          , Hh          , Gs^Fp       , Hh          , Gs^Fp       , Hh          , Gg          , Gs^Fp       , Gs^Fp       , Hh          , Gg          , Gs^Fp       , Gg          , Hh          , 3 Hh        , Mm          , Mm          , Mm^Xm       , Mm^Xm       , Mm^Xm       
Mm^Xm       , Mm^Xm       , Mm          , Hh          , Gg^Efm         , Gg          , Gg          , Gg          , Re^Gvs      , Gg          , Gg          , Gg          , Gg^Efm         , Gg          , Gg          , Gg          , 1 Rd        , 2 Rd        , Hh          , Mm          , Mm^Xm       , Mm^Xm       
Mm^Xm       , Mm^Xm       , Hh          , Hh          , Re^Gvs      , Re^Gvs      , Re^Gvs      , Re^Gvs      , Re^Gvs      , Re^Gvs      , Gg          , Gg          , Gg          , Hh          , Rd          , Rd          , Gg          , Gg          , Gg          , Hh          , Mm^Xm       , Mm^Xm       
Mm^Xm       , Mm^Xm       , Gs^Fp       , Hh          , Re^Gvs      , Re^Gvs      , Gg^Wm       , Re^Gvs      , Gg          , Gg          , Ce          , Ce          , Ce          , Gg          , Rd          , Gs^Fp       , Gg          , Hh          , Gg^Efm         , Gg          , Mm^Xm       , Mm^Xm       
Mm^Xm       , Mm^Xm       , Gs^Fp       , Gg          , Gg          , Re^Gvs      , Gg          , Gg          , Ce          , Ce          , Gg^Vo       , Gs^Fp       , Rp          , Rd          , Ce          , Gg          , Gg          , Gs^Fp       , Gg          , Hh          , Mm^Xm       , Mm^Xm       
Mm^Xm       , Mm^Xm       , Hh          , Hh          , Gg          , Gg          , Gg          , Gg          , Ce          , Gs^Fp       , Gs          , Rp          , Gg          , Rp          , Gg^Vo       , Ce          , Ce          , Gg^Efm         , Gg          , Gs^Fp       , Mm^Xm       , Mm^Xm       
Mm          , Mm          , Hh          , Gg          , Gg          , Gs^Fp       , Gg          , Ce          , Gs^Fp       , Gg^Vo       , Rp          , Rp          , Rp^Vh0      , Rp          , Rp          , Gs^Fp       , Ce          , Gg          , Hh          , Hh          , Mm^Xm       , Mm^Xm       
Ww          , Hh          , Gg          , Gg          , Gg          , Gg          , Gg          , Ce          , Gg^Vo       , Rp          , Rp          , Gg^Ve0      , Rr          , Rp^Vh0      , Rp          , Gg^Vo       , Ce          , Gg          , Gs^Fp       , Hh          , Mm^Xm       , Mm^Xm       
Wo          , Ww          , Ww          , Gs^Fp       , Gg          , Hh          , Gg          , Ce          , Ce          , Gg^Vo       , Gs^Fp       , Rp          , Gg^Fet      , Rp          , Gs^Fp       , Gg^Vo       , Ce          , Gg          , Gg^Efm         , Hh          , Mm^Xm       , Mm^Xm       
Wo          , Wo          , Wo          , Ww          , Ww          , Gg          , Gg          , Gs^Fp       , Gg          , Ce          , Ce          , Rd          , Ce          , Gg^Vo       , Ce          , Ce          , Gs^Fp       , Gg          , Gs^Fp       , Hh          , Hh          , Mm^Xm       
Wo          , Wo          , Wo          , Wo          , Wo          , Ww          , Gs^Fp       , Gg          , Gg          , Gg          , Rd          , Rd          , Gg          , Ce          , Ds          , Gg          , Ds          , Ds          , Ds          , Ds          , Ww          , Ww          
Wo          , Wo          , Wo          , Wo          , Wo          , Ww          , Ww          , Ds          , Rd          , Rd          , Gs^Fp       , Gg          , Ww          , Ds          , Ww          , Ds          , Ww          , Ww          , Ww          , Ww          , Wo          , Wo          
Wo          , Wo          , Wo          , Wo          , Wo          , Wo          , Wo          , Ww^Bw/      , Ww          , Ww          , Ww          , Ww          , Wo          , Ww          , Wo          , Ww          , Wo          , Wo          , Wo          , Wo          , Wo          , Wo          
Wo          , Wo          , Wo          , Wo          , Wo          , Wo          , Wo          , Wo          , Wo          , Wo          , Wo          , Wo          , Wo          , Wo          , Wo          , Wo          , Wo          , Wo          , Wo          , Wo          , Wo          , Wo          
